1111111111111111
1011000C11000011
101111C011000C01
1000000011P01111
1111100000001111
1111111100E01111
11111100000C1111
1111000001111111
11C0011111111111
1110111111111111
1110111111111111
1110111C1111C111
1110111011110111
1110111011110111
1110111011110111
1110000000000111
1111111111111111
