1111111111111111
1011000C11000011
101111C011000C01
1000000000P11111
1111100001001111
1111110001E01111
1111110000001111
1110000001111111
11C1011111111111
1111111111111111
